1111111111111
1P01C00000001
110E000000001
1101110111111
110000C000001
11C0CCC110001
1111111111111
