1111111111111
1001C00011111
110E000P11111
1101110111111
111111C111111
11C0CCC111111
1111111111111
