1111111111111
1P01000000001
11CE000000001
1101110111111
1100000000101
1100000110011
1111111111111
