1111111111111
1P01000000001
110E000000001
1101110111111
1100000000101
1100000110C11
1111111111111
